ぶり		Japanese Amberjack
ふるさと		Hometown, Birthplace
様子	ようす	State, state of affairs
大声	おおごえ	Loud voice
つまり		In other word
迷惑	めいわく	Trouble, bother
袋	ふくろ	Sack, Bag, Pouch
郵便	ゆうびん	Mail service
環境	かんきょう	Environment
優勝	ゆうしょう	Victory, Championship


満足	まんぞく	Satisfaction, Sufficient
得る	える	Gain. Get
その後	そのあと	After that. Afterwards
気を付ける	きをつける	To be careful. To take care
守る	まもる	Guard, Protect
落ちる	おちる	Fail, Drop
しやすい		Easy to make. Easy to Do


世界	せかい	The world, Sphere
水準	すいじゅん	Level, standard, water level
哲学	てつがく	Philosophy
涙	なみだ	Tears, Sympathy
さらに		Furthermore, again
怒り	いかり	Anger, Rage, Fury
深い	ふかい	Deep, Profound, Thick


あまり		Too much
全体	ぜんたい	Whole, Entirely
利益	りえき	Profit. Gains. Benefit
下がる	さがる	To come down. Go down
つつ		While, Even though
過ぎる	すぎる	To pass through, to beyond
直接	ちょくせつ	Direct, Immediate
示す	しめす	To show, to demonstrate


地域	ちいき	Area, Region
人々	ひとびと	Each Person, Person
豊か	ゆたか	Wealthy, Very
住民	じゅうみん	Citizens, inhabitants
疑問	ぎもん	Question, Problem
政府	せいふ	Government
幼稚園	ようちえん	Kindergarten
物事	ものごと	Things, Everything
経験	けいけん	Experience
主役	しゅやく	Leading (Part, Actor)
位	い	Rank, Grade


生産	せいさん	Production, Live Birth
増加	ぞうか	Increase, Increment
大学院	だいがくいん	Graduate School
留学	りゅうがく	Studying Abroad
離れる	はなれる	To be separated. To leave
不安	ふあん	Anxiety, Insecurity
結婚式	けっこんしき	Marriage Ceremony
参加	さんか	Participation


分	ぶん	Part
供給	きょうきゅう	Supply, Provision
文化	ぶんか	Culture, Civilization
表す	あらわす	To Express, To reveal
体験	たいけん	Personal Experience
交際	こうさい	Company, Friendship
続く	つづく	To continue
疲れ	つかれ	Tiredness, Fatigue
あるいは		Or, Possibly
筋トレ	きんとれ	Weight Training
きたえる		Forge, Discipline, Train

